{
  "layer0": [
    [7,7,7,7,7,7,-1,7],
    [7,7,7,6,6,4,7,7],
    [7,7,7,21,23,29,6,6],
    [7,7,7,22,23,22,23,21],
    [7,7,7,23,21,23,21,23],
    [7,7,7,22,22,23,21,5],
    [7,7,5,5,5,5,3,7],
    [7,7,7,7,7,7,7,7]
  ],
  "doors": [
    {
      "id": -1,
      "to": "kitchen",
      "tile": 0
    }
  ]
}